1000,1000,1000,1000,1000,1000,1000,1000,1000,1000
1000,1000,1000,1000,1000,1000,1000,1000,1000,1000
1000,1000,1000,1000,1000,1000,1000,1000,1001,1000
1000,1000,1000,1000,1000,1000,1000,1001,1001,1000
1000,1000,1000,1000,1000,1000,1000,1001,1001,1000
1000,1000,1000,1000,1000,1000,1000,1000,1000,1000
1000,1000,1000,1000,1001,1000,1000,1000,1000,1000
1000,1000,1000,1001,1001,1001,1000,1000,1000,1000
1000,1000,1000,1001,1001,1001,1000,1000,1000,1000
1000,1000,1000,1001,1001,1000,1000,1000,1000,1000
1000,1000,1000,1000,1000,1000,1000,1000,1000,1000
1000,1000,1000,1000,1000,1000,1000,1000,1000,1000
1000,1000,1000,1000,1000,1000,1000,1000,1001,1000
1000,1000,1000,1000,1000,1000,1000,1001,1001,1000
1000,1000,1000,1000,1000,1000,1000,1001,1001,1000
1000,1000,1000,1000,1000,1000,1000,1000,1000,1000
1000,1000,1000,1000,1001,1000,1000,1000,1000,1000
1000,1000,1000,1001,1001,1001,1000,1000,1000,1000
1000,1000,1000,1001,1001,1001,1000,1000,1000,1000
1000,1000,1000,1001,1001,1000,1000,1000,1000,1000
1000,1000,1000,1000,1000,1000,1000,1000,1000,1000
1000,1000,1000,1000,1000,1000,1000,1000,1000,1000
1000,1000,1000,1000,1000,1000,1000,1000,1001,1000
1000,1000,1000,1000,1000,1000,1000,1001,1001,1000
1000,1000,1000,1000,1000,1000,1000,1001,1001,1000
1000,1000,1000,1000,1000,1000,1000,1000,1000,1000
1000,1000,1000,1000,1001,1000,1000,1000,1000,1000
1000,1000,1000,1001,1001,1001,1000,1000,1000,1000
1000,1000,1000,1001,1001,1001,1000,1000,1000,1000
1000,1000,1000,1001,1001,1000,1000,1000,1000,1000
1000,1000,1000,1000,1000,1000,1000,1000,1000,1000
1000,1000,1000,1000,1000,1000,1000,1000,1000,1000
1000,1000,1000,1000,1000,1000,1000,1000,1001,1000
1000,1000,1000,1000,1000,1000,1000,1001,1001,1000
1000,1000,1000,1000,1000,1000,1000,1001,1001,1000
1000,1000,1000,1000,1000,1000,1000,1000,1000,1000
1000,1000,1000,1000,1001,1000,1000,1000,1000,1000
1000,1000,1000,1001,1001,1001,1000,1000,1000,1000
1000,1000,1000,1001,1001,1001,1000,1000,1000,1000
1000,1000,1000,1001,1001,1000,1000,1000,1000,1000
1000,1000,1000,1000,1000,1000,1000,1000,1000,1000
1000,1000,1000,1000,1000,1000,1000,1000,1000,1000
1000,1000,1000,1000,1000,1000,1000,1000,1001,1000
1000,1000,1000,1000,1000,1000,1000,1001,1001,1000
1000,1000,1000,1000,1000,1000,1000,1001,1001,1000
1000,1000,1000,1000,1000,1000,1000,1000,1000,1000
1000,1000,1000,1000,1001,1000,1000,1000,1000,1000
1000,1000,1000,1001,1001,1001,1000,1000,1000,1000
1000,1000,1000,1001,1001,1001,1000,1000,1000,1000
1000,1000,1000,1001,1001,1000,1000,1000,1000,1000